00000000
0r----R0
00000000
........
........
........
........
........