000000000000
0ybrc------0
0-----Y----0
00---C-----0
.0--B-000000
.0-R--0.....
.000000.....
............
............
............
............
............