000000000.
0r------@.
0-00000-0.
0-00000-0.
0------R0.
000000000.
..........
..........
..........
..........