.00000000
.0--0---0
.@--br--0
.0-B---00
.0R----0.
.000@000.
.........
.........
.........