...000000.000000
00000--P000Y00C0
0rbc--0--------0
0yp---------0--0
00000W00B0000000
....0000@0......
................
................
................
................
................
................
................
................
................
................