........0000
00000..00-P0
0WCY0000---0
0---cpyr---0
000000000000
............
............
............
............
............
............
............