.000000000..
.@WB----r0..
.0C------000
.0---------0
.0--bc---0-0
.000-000-0-0
...0-------0
...000000000
............
............
............
............