00000000
0--0---0
0r-----0
0------0
0000R000
...000..
........
........