...000.....
...0-000000
0000------0
0-0----0--0
0--R------0
0r----0---0
0----000000
0----0.....
000000.....
...........
...........