............
...0000000..
...0-----0..
..00--R--0..
.00----0r0..
.0---0---00.
.0--------0.
.0-0------0.
.0------000.
.00000000...
............
............
............