.000000....
.0R---00...
.0--B--000.
.0-----br0.
.000000000.
...........
...........
...........
...........
...........
...........