....00000
....0---0
00000R0-0
0---r-0-0
0--B0b0-0
0-------0
0-------0
000000000
.........
.........