..00000000..
.00------00.
00--0-B0--00
0--0-R--0--0
0----0--00-0
0r0-00---0b0
0---0------0
000000000000
............
............
............
............