.000....
00Y00000
0yrb---0
0B0R0000
00000...
........
........
........