.0000000.
.0-----0.
.0-C-0-0.
00-000-0.
0-yrc--0.
0-0000-0.
0-0-Y0R0.
0------0.
00000000.